What’s your telephone number?	My number is 845 676
What’s your email address?	You can email me at john@gmail.com
How old are you?	Thirty-eight.
I’m Thirty-eight years old.	When and where were you born?
I was born in 1974 in London.	Are you married?
No am single	Yes, I am married
What’s your marital status?	I’m married.
What do you do? or What’s your job?	I’m an English teacher.
Where did you go?	I went  shopping with a friend.
What did you buy?	We bought some new clothes on sale.
Where were you?		I was in London for the weekend.	I teach English at the High School.
Have you got a car / job / house / etc.?	Yes, I’ve got a hatch back.	
Have you got a house?	No, I live in a flat.	
Have you got any children?	Yes, I’ve got three children.	Two boys and a daughter.	
Can you play tennis?	Yes, I can play Tennis.	Yes, I drive a sedan.
Can you speak English?	No, I can’t speak Chinese.	
Could you speak English when you were five years old?	Yes, I could speak English when I was five years old.	No, not yet.
How do you do?	How do you do. Pleased to meet you.	No, I play football.
How are you?	Fine, thanks. And you?	Yes, I can. But I am not fluent, I am learning to speak English.
How can I help you?	May I help you?	No, I couldn’t. English is not my native language.
Can I try it on?	No thanks, I am just looking around.	
Have you got something bigger?	Sure, the changing rooms are over there.	
How much does it cost? How much is it?	Certainly, we’ve got  larger sizes as well.	Yes. I’m looking for a sweater.
How would you like to pay?	This shirt is for 50$	
Can I pay by credit card?	Certainly. We accept all the major cards.	
What’s that?	It’s a smart watch.	
What time is it?	It’s one o’clock.	I would like to pay by cash.
May I open the window?	Certainly. It’s very hot in the office today!	
Is there a bakery near here?	Yes. There is a bakery nearby, take the next corner and it’s next to the bank.	
Where is the nearest bank?	The nearest bank is on united street.	
Who wrote this article?		Michelle wrote this article “The Sun Also Rises”.	
Is there any rice?	Yes, there’s a lot of rice left.	
Are there any sandwiches?	No, there aren’t any sandwiches left.	
Is this your book?	No, I think it’s his book.	
Whose is that?	It’s Henry.	 My sisters fiance	
What do you like to do on weekends?	I like playing cricket, reading and listening to pop music.	
What does she look like?	She’s tall and slim with blonde hair.	
What would you like to eat?	I’d like a burger, chips and soda.	
What is it like?	It’s an interesting country many things to see and do.	
What’s the weather like?	It’s raining heavily at the moment.	
Would you like some coffee?	Yes, thank you. I’d like some coffee.	
Would you like something to drink?	Thank you.	 Could I have a cup of coffee and some cake?	
What’s it about?	It’s about a young girl who has many adventures.	
What do you think about this book?	I think the book is very interesting.	
Is it difficult to prepare for IELTS?	It’s not if your practice well.	
What are your views on Donald Trump as the America’s President?		That’s a good question, well I am speechless.	
How was the movie?	It was very interesting. 	You should watch it.	
How do you feel about Clara?	Clara is quite friendly and helpful.	
How about I pick you up at eight o’clock on my way to the airport?	Great. I’ll see you then.	
how about some lunch?	Yeah! Sure, I am hungry.	
Why don’t you take some time out and rest?	That’s a good idea.	
What shall we do this evening?	Let’s go see a movie.	
Why don’t we go out visit some old friends this afternoon?	Yes, that sounds like a great idea.	


